# 구현해야 할 목록들입니다.
home=com.jeju.controller.HomeController

# member section
meLogin=com.jeju.controller.member.MemberLoginController
meLogout=com.jeju.controller.member.MemberLogoutController
meInsert=com.jeju.controller.member.MemberInsertController
#meList=com.jeju.controller.member.MemberListController
meDetail=com.jeju.controller.member.MemberDetailController
meMenu=com.jeju.controller.member.MemberMenuController
meUpdate=com.jeju.controller.member.MemberUpdateController
meDelete=com.jeju.controller.member.MemberDeleteController
meDeleteProcess=com.jeju.controller.member.MemberDeleteProcessServlet


# food section
fdMain=com.jeju.controller.food.FoodMainController
fdDetail=com.jeju.controller.food.FoodDetailController
fdLikes=com.jeju.controller.food.FoodLikesController
fdInsert=com.jeju.controller.food.FoodInsertController
fdDelete=com.jeju.controller.food.FoodDeleteController
fdUpdate=com.jeju.controller.food.FoodUpdateController

# tour section
trMain=com.jeju.controller.tour.TourMainController
trList=com.jeju.controller.product.TourListController
trInsert=com.jeju.controller.tour.TourInsertController
trUpdate=com.jeju.controller.tour.TourUpdateController
trDetail=com.jeju.controller.tour.TourDetailController
#trDelete=com.jeju.controller.tour.TourDeleteController
trLikes=com.jeju.controller.tour.TourLikesController


# event section
evMain=com.jeju.controller.event.EventMainController
#cmList=com.jeju.controller.comment.CommentListController
#cmInsert=com.jeju.controller.comment.CommentInsertController
#cmDelete=com.jeju.controller.comment.CommentDeleteController

# free board section
frMain=com.jeju.controller.free.freeBoardMainController
frDetail=com.jeju.controller.free.freeBoardDetailController
frInsert=com.jeju.controller.free.freeInsertController
frUpdate=com.jeju.controller.free.freeUpdateController
frEmoticon=com.jeju.controller.free.freeEmoticonController
